6 16 96 2
6100
01 02 03 05 06
03 04
144 192 168 192 144
144 144
168 168 168 168 168 168 168 168 168 168 168 168 168 168 168 168
168 168 168 168 168 168 168 168 168 168 168 168 168 168 168 168
0.167 0.125 0.143 0.125 0.167
0.167 0.167
540 1676 247 0 130 97
0 0 0 0 0 0
79 79 118 118 77 77 115 115 108 108 161 161 109 109 163 163
480 480 720 720 480 480 720 720 600 600 900 900 658 658 987 987
721 721 1081 1081 719 719 1078 1078 1273 1273 1610 1610 1266 1266 1699 1699
66 66 99 99 66 66 99 99 66 66 99 99 66 66 99 99
44 44 66 66 44 44 66 66 44 44 66 66 44 44 66 66
56 56 84 84 56 56 84 84 56 56 84 84 56 56 84 84
0 6 6 6 0.5
6 0 6 0.5 6
6 6 0 6 6
6 0.5 6 0 6
0.5 6 6 6 0
0 0.5
0.5 0
0.790075 0.835575 0.494541667 0.611108333 0.866558333 0.786716667
7.90075 8.35575 4.945416667 6.111083333 8.665583333 7.867166667
0 0 0 0 0
1.52471 0
0 450 450 450 70
450 0 450 80 450
450 450 0 450 450
450 80 450 0 450
70 450 450 450 0
0 250
250 0
