26 16 112 8
199000
04 07 13 14 17
06 08 15 16 19
02 08
02 06 08 11 12 22 23 24
02 03 10 11 12 18
02 08 10 11 12 18
02 04 05 09 11 12 13 14
01 02 11 12 20 21 24 25 26
564 564 564 564 564
528 744 528 528 552
384 744
612 528 1188 612 612 504 540 504
648 672 660 672 672 660
756 1512 696 756 756 696
612 660 660 1320 612 612 660 660
456 636 636 636 2244 2244 504 444 360
168 168 168 168 168 168 168 168 168 168 168 168 168 168 168 168
168 168 168 168 168 168 168 168 168 168 168 168 168 168 168 168
168 168 168 168 168 168 168 168 168 168 168 168 168 168 168 168
168 168 168 168 168 168 168 168 168 168 168 168 168 168 168 168
168 168 168 168 168 168 168 168 168 168 168 168 168 168 168 168
168 168 168 168 168 168 168 168 168 168 168 168 168 168 168 168
168 168 168 168 168 168 168 168 168 168 168 168 168 168 168 168
168 168 168 168 168 168 168 168 168 168 168 168 168 168 168 168
0.021276596 0.021276596 0.021276596 0.021276596 0.021276596
0.022727273 0.016129032 0.022727273 0.022727273 0.02173913
0.03125 0.016129032
0.019607843 0.022727273 0.01010101 0.019607843 0.019607843 0.023809524 0.022222222 0.023809524
0.018518519 0.017857143 0.018181818 0.017857143 0.017857143 0.018181818
0.015873016 0.007936508 0.017241379 0.015873016 0.015873016 0.017241379
0.019607843 0.018181818 0.018181818 0.009090909 0.019607843 0.019607843 0.018181818 0.018181818
0.026315789 0.018867925 0.018867925 0.018867925 0.005347594 0.005347594 0.023809524 0.027027027 0.033333333
2963 29591 9556 8333 5205 11592 7777 15978 4237 8140 7518 3829 4419 1596 1047 844 326 154 1988 8815 7840 5303 4885 3475 2300 3678
0 0 0 0 0 0 0 0 0 0 0 0 0 0 0 0 0 0 0 0 0 0 0 0 0 0
451 601 752 1202 450 600 750 1199 712 712 1067 1067 516 688 860 1375
6730 8974 11217 17947 6543 8725 10906 17449 10192 10192 15288 15288 6919 9226 11532 18451
1578 2104 2630 4207 1579 2106 2632 4212 2107 2107 3161 3161 1621 2161 2701 4322
3260 4347 5434 8694 3338 4451 5563 8901 4665 4665 6997 6997 3366 4489 5611 8977
1004 1339 1674 2678 1025 1367 1709 2734 1352 1352 2029 2029 1023 1364 1705 2728
3751 5002 6252 10003 3764 5019 6273 10037 5110 5110 7666 7666 3835 5113 6391 10226
2074 2765 3456 5530 1978 2637 3296 5274 2711 2711 4066 4066 1877 2502 3128 5004
4430 5906 7383 11812 4062 5416 6770 10832 5419 5419 8129 8129 4069 5425 6781 10850
2669 3559 4449 7118 2479 3305 4131 6610 3332 3332 4997 4997 2581 3441 4301 6882
1361 1814 2268 3628 1371 1828 2285 3656 1468 1468 2202 2202 1226 1634 2043 3268
1976 2635 3293 5269 1935 2580 3225 5160 2411 2411 3617 3617 1904 2538 3173 5076
2309 3079 3849 6158 1977 2635 3294 5271 1627 1627 2440 2440 1659 2212 2765 4424
679 905 1132 1811 680 907 1133 1813 901 901 1351 1351 675 900 1125 1800
462 615 769 1231 713 951 1189 1902 1397 1397 2095 2095 1012 1349 1687 2699
690 920 1150 1839 660 880 1100 1760 552 552 827 827 387 516 645 1032
327 436 545 872 304 406 507 812 395 395 593 593 334 446 557 891
357 477 596 953 298 398 497 795 407 407 611 611 324 431 539 863
263 351 439 702 264 352 440 703 355 355 533 533 263 351 439 702
348 464 581 929 342 455 569 911 433 433 649 649 323 431 539 862
1832 2443 3054 4886 1771 2361 2952 4723 2042 2042 3064 3064 1434 1913 2391 3825
1505 2006 2508 4012 1494 1992 2490 3983 1593 1593 2389 2389 1224 1632 2041 3265
1450 1933 2417 3866 1486 1981 2477 3963 2072 2072 3107 3107 1538 2051 2564 4102
1561 2082 2602 4163 1599 2131 2664 4263 2235 2235 3352 3352 1655 2206 2758 4413
943 1257 1571 2514 980 1307 1633 2613 1284 1284 1926 1926 908 1211 1513 2421
960 1279 1599 2559 185 246 308 492 277 277 415 415 816 1088 1360 2176
670 893 1117 1787 950 1266 1583 2533 1059 1059 1589 1589 1297 1729 2162 3458
0 3 2 2 4
3 0 4 4 2
2 4 0 2 4
2 4 2 0 3
4 2 4 3 0
0 6 2 2 4
6 0 6 6 6
2 6 0 2 4
2 6 2 0 4
4 6 4 4 0
0 4
4 0
0 3 6 2 2 4 2 6
3 0 6 4 4 2 4 6
6 6 0 6 6 6 6 6
2 4 6 0 2 4 2 6
2 4 6 2 0 4 2 6
4 2 6 4 4 0 4 6
2 4 6 2 2 4 0 6
6 6 6 6 6 6 6 0
0 3 4 2 2 4
3 0 4 3 3 4
4 4 0 2 2 4
2 3 2 0 2 4
2 3 2 2 0 3
4 4 4 4 3 0
0 4 4 2 2 4
4 0 4 4 4 4
4 4 0 4 4 2
2 4 4 0 2 4
2 4 4 2 0 4
4 4 2 4 4 0
0 4 4 4 2 2 4 4
4 0 3 4 4 4 2 2
4 3 0 4 4 4 2 2
4 4 4 0 4 4 4 4
2 4 4 4 0 2 4 4
2 4 4 4 2 0 4 4
4 2 2 4 4 4 0 2
4 2 2 4 4 4 2 0
0 6 6 6 6 6 6 6 6
6 0 2 2 5 5 5 5 5
6 2 0 2 5 5 5 5 5
6 2 2 0 5 5 5 5 5
6 5 5 5 0 3 5 2 2
6 5 5 5 3 0 5 3 3
6 5 5 5 5 5 0 3 3
6 5 5 5 2 3 3 0 3
6 5 5 5 2 3 3 3 0
